2222222222222222222222222
20B00000B0000000B00000B02
2000000000000000000000002
2001110000B000B0000111002
20B1110B002222200B0111B02
2001110000211120000111002
2001110000000000000111002
2000000000000000000000002
2000000000000000000000002
2000011110000000111100002
2000000000000000000000002
2000000000000000000000002
2000000000011100000000002
2000010000022200000100002
2000000000000000000000002
2000010000011100000100002
200001000001C100A00100002
2222222222222222222222222